41 41 41 41 41 41 41 41 41 41 41 41 41 41 41 41 41 41 41 41 41 41 41 41 41 41 41 41 41 41 41 41 41 41 41 41 41 41 41 41 41 41 41 41 41 41 41 41 41 41
41 10 10 10 10 10 10 10 10 10 10 10 10 10 10 10 10 10 10 10 10 11 10 10 10 10 10 10 10 10 10 10 10 10 10 10 10 10 10 10 10 10 10 10 11 10 10 10 10 41
41 10 10 10 10 10 10 10 10 10 10 10 10 10 10 10 10 10 10 11 10 10 10 10 10 10 10 10 10 10 10 10 10 10 10 10 10 10 10 10 10 10 11 10 10 10 10 10 10 41
41 10 10 10 10 10 10 10 10 10 10 10 10 10 10 10 10 11 10 10 10 10 10 10 10 10 10 10 10 10 10 10 10 10 10 10 10 10 10 10 11 10 10 10 10 10 10 10 10 41
41 10 10 10 41 41 41 10 10 10 10 10 10 10 10 11 10 10 10 10 10 10 10 10 10 10 10 10 10 10 10 10 10 10 10 10 10 10 11 10 10 10 10 10 10 10 10 10 10 41
41 10 10 10 41 41 41 10 10 10 10 10 10 11 10 10 10 10 10 10 10 10 10 10 10 10 10 10 10 10 10 10 10 10 10 10 11 10 10 10 10 10 41 41 41 10 10 10 10 41
41 10 10 10 41 41 41 10 10 10 10 11 10 10 10 10 10 10 10 10 10 10 39 39 39 39 39 10 10 10 10 10 10 10 11 10 10 10 10 10 10 10 41 41 41 10 10 10 10 41
41 10 10 10 10 10 10 41 41 41 10 10 10 10 10 10 10 10 10 10 10 10 39 39 39 39 39 10 10 10 10 10 11 10 10 10 10 10 10 10 10 10 41 41 41 10 10 10 10 41
41 10 10 10 10 10 10 41 41 41 10 10 10 10 10 10 10 10 10 10 10 10 39 39 39 39 39 10 10 10 11 10 10 10 10 10 10 10 10 10 10 10 10 10 10 10 10 10 10 41
41 10 10 10 10 11 10 41 41 41 10 10 10 10 10 10 10 10 10 10 10 10 39 39 39 39 39 10 11 10 10 10 10 10 10 10 10 10 10 10 10 10 10 10 41 41 41 10 10 41
41 10 10 11 10 10 10 10 10 10 10 10 10 10 10 10 10 10 10 10 10 10 39 39 39 39 39 39 39 39 10 10 10 10 10 10 10 10 10 10 10 10 10 10 41 41 41 10 10 41
41 11 10 10 10 10 10 10 10 10 10 10 10 10 10 10 10 10 10 10 10 10 39 39 39 39 39 39 39 39 10 10 10 10 10 10 10 10 10 10 10 10 10 10 41 41 41 11 10 41
41 10 10 10 10 10 10 10 10 10 10 10 10 39 39 39 39 10 10 10 10 10 39 39 39 39 39 39 39 39 10 10 10 10 10 39 39 39 39 39 10 10 10 10 10 11 10 10 10 41
41 10 10 10 10 10 10 10 10 10 10 10 10 39 39 39 39 10 10 10 11 10 39 39 39 39 39 39 39 39 10 10 10 10 10 39 39 39 39 39 10 10 10 11 10 10 10 10 10 41
41 10 10 10 10 10 10 39 39 39 39 39 39 39 39 39 39 39 39 39 39 39 39 39 39 39 39 39 39 39 39 39 39 39 39 39 39 39 39 39 39 39 39 10 10 10 10 10 10 41
41 10 10 10 10 10 10 39 39 39 39 39 39 39 39 39 39 39 39 39 39 39 39 39 39 39 39 39 39 39 39 39 39 39 39 39 39 39 39 39 39 39 39 10 10 10 10 10 10 41
41 10 10 10 10 10 10 39 39 39 39 39 39 39 39 39 39 39 39 39 39 39 39 39 39 39 39 39 39 39 39 39 39 39 39 39 39 39 39 39 39 39 39 10 10 10 10 10 10 41
41 10 10 10 10 10 10 39 39 39 39 39 39 39 39 39 39 39 39 39 39 39 39 39 39 39 39 39 39 39 39 39 39 39 39 39 39 39 39 39 39 39 39 10 10 10 10 10 10 41
41 10 10 10 10 10 10 39 39 39 39 39 39 39 39 39 39 39 39 39 39 39 39 39 39 39 39 39 39 39 39 39 39 39 39 39 39 39 39 39 39 39 39 10 10 10 10 10 10 41
41 10 10 10 10 10 10 10 11 10 10 10 10 39 39 39 39 39 39 39 39 39 39 39 39 39 39 39 39 39 39 39 39 39 39 39 39 10 10 10 10 10 10 10 10 10 10 10 10 41
41 10 10 10 10 10 11 10 10 10 10 10 10 39 39 39 39 39 39 39 39 39 39 39 39 39 39 39 39 39 39 39 39 39 39 39 39 10 10 10 10 10 10 10 10 10 10 10 10 41
41 10 10 10 11 10 10 10 10 10 10 10 10 39 39 39 39 39 39 39 39 39 39 39 39 39 39 39 39 39 39 39 39 39 39 39 39 10 10 10 10 10 10 10 10 10 10 10 10 41
41 10 11 10 10 10 10 10 10 10 10 10 10 39 39 39 39 39 39 39 39 39 39 39 39 39 39 39 39 39 39 39 39 39 39 39 39 10 10 10 10 10 10 10 10 10 10 10 11 41
41 10 10 10 10 10 10 10 10 10 10 10 10 39 39 39 39 39 39 39 39 39 39 39 39 39 39 39 39 39 39 39 39 39 39 39 39 39 39 39 39 39 10 41 41 41 11 10 10 41
41 10 10 10 41 41 41 10 10 10 10 10 10 39 39 39 39 39 39 39 39 39 39 39 39 39 39 39 39 39 39 39 39 39 39 39 39 39 39 39 39 39 10 41 41 41 10 10 10 41
41 10 10 10 41 41 41 10 10 10 39 39 39 39 39 39 39 39 39 39 39 39 39 39 39 39 39 39 39 39 39 39 39 39 39 39 39 39 39 39 39 39 11 41 41 41 10 10 10 41
41 10 10 10 41 41 41 10 10 10 39 39 39 39 39 39 39 39 39 39 39 39 39 39 39 39 39 39 39 39 39 39 39 39 39 39 39 39 39 39 39 39 10 10 10 10 10 10 10 41
41 10 10 10 10 10 10 10 10 10 39 39 39 39 39 39 39 39 39 39 39 39 39 39 39 39 39 39 39 39 39 39 39 39 39 39 39 39 39 39 39 39 10 10 10 10 10 10 10 41
41 10 10 10 10 10 10 10 10 10 39 39 39 39 39 39 39 39 10 10 10 10 39 39 39 39 39 10 10 39 39 39 39 39 39 39 39 39 39 39 39 39 10 10 10 10 10 10 10 41
41 10 10 10 10 10 10 10 10 10 39 39 39 39 39 39 39 39 10 10 10 10 39 39 39 39 39 10 10 39 39 39 39 39 39 39 39 39 39 39 39 39 10 10 10 10 10 10 10 41
41 10 10 10 10 10 10 10 10 39 39 39 39 39 39 39 39 39 39 39 39 39 39 39 39 39 39 39 39 39 39 39 39 39 39 39 39 39 39 39 39 39 10 10 10 10 10 10 10 41
41 10 10 10 10 10 10 11 10 39 39 39 39 39 39 39 39 39 39 39 39 39 39 39 39 39 39 39 39 39 39 39 39 39 39 39 39 39 39 39 39 10 10 10 10 10 10 10 10 41
41 10 10 10 10 11 10 10 10 39 39 39 39 39 39 39 39 39 39 39 39 39 39 39 39 39 39 39 39 39 39 39 39 39 39 39 39 39 39 39 39 10 10 10 10 10 10 10 10 41
41 10 10 11 10 10 10 10 10 39 39 39 39 39 39 39 39 39 39 39 39 39 39 39 39 39 39 39 39 39 39 39 39 39 39 39 39 39 39 39 39 10 10 10 10 10 10 10 10 41
41 11 10 10 10 10 10 10 10 10 10 10 10 10 10 10 10 10 10 10 10 10 39 39 39 39 39 10 10 10 10 10 10 10 10 10 10 10 10 10 10 10 10 10 10 10 10 11 10 41
41 10 10 10 10 10 10 10 10 10 10 10 10 10 10 10 10 10 10 10 10 10 39 39 39 39 39 10 10 10 10 10 10 10 10 10 10 10 10 10 10 10 10 10 10 11 10 10 10 41
41 10 10 10 10 10 10 12 12 12 10 10 10 10 10 10 10 10 10 10 11 10 39 39 39 39 39 10 10 10 10 10 10 10 10 10 10 10 10 10 10 10 10 11 10 10 10 10 10 41
41 10 10 10 10 10 12 12 12 12 12 10 10 10 10 10 10 10 11 10 10 10 39 39 39 39 39 10 10 10 10 10 10 10 10 10 10 10 10 10 10 11 10 10 10 10 10 10 10 41
41 10 10 10 10 12 12 12 12 12 12 12 10 10 10 10 11 10 10 10 10 10 39 39 39 39 39 10 10 10 10 10 10 10 10 10 10 10 10 11 10 10 41 41 41 10 10 10 10 41
41 10 10 10 10 12 12 12 12 12 12 12 10 10 11 41 41 41 10 10 10 10 39 39 39 39 39 10 10 10 10 10 10 10 10 10 10 11 10 10 10 10 41 41 41 10 10 10 10 41
41 10 10 10 10 12 12 12 12 12 12 12 11 10 10 41 41 41 10 10 10 10 39 39 39 39 39 10 10 10 10 10 10 10 10 11 10 10 10 10 10 10 41 41 41 10 10 10 10 41
41 10 10 10 10 10 12 12 12 12 12 10 10 10 10 41 41 41 10 10 10 10 39 39 39 39 39 10 10 10 10 10 10 11 10 10 41 41 41 10 10 10 10 10 10 10 10 10 10 41
41 10 10 10 10 10 10 12 12 12 10 10 10 10 10 10 10 10 10 10 10 10 39 39 39 39 39 10 10 10 10 11 10 10 10 10 41 41 41 10 10 10 10 10 10 10 10 10 10 41
41 10 10 10 10 10 11 10 10 10 10 10 10 10 10 10 10 10 10 10 10 10 39 39 39 39 39 10 10 11 10 10 10 10 10 10 41 41 41 10 10 10 10 10 10 10 10 10 10 41
41 10 10 10 11 10 10 10 10 10 10 10 10 10 10 10 10 10 10 10 10 10 10 10 10 10 10 11 10 10 10 10 10 10 10 10 10 10 10 10 10 10 10 10 10 10 10 10 10 41
41 10 11 10 10 10 10 10 10 10 10 10 10 10 10 10 10 10 10 10 10 10 10 10 10 11 10 10 10 10 10 10 10 10 10 10 10 10 10 10 10 10 10 10 10 10 10 10 11 41
41 10 10 10 10 10 10 10 10 10 10 10 10 10 10 10 10 10 10 10 10 10 10 11 10 10 10 10 10 10 10 10 10 10 10 10 10 10 10 10 10 10 10 10 10 10 11 10 10 41
41 10 10 10 10 10 10 10 10 10 10 10 10 10 10 10 10 10 10 10 10 11 10 10 10 10 10 10 10 10 10 10 10 10 10 10 10 10 10 10 10 10 10 10 11 10 10 10 10 41
41 10 10 10 10 10 10 10 10 10 10 10 10 10 10 10 10 10 10 11 10 10 10 10 10 10 10 10 10 10 10 10 10 10 10 10 10 10 10 10 10 10 11 10 10 10 10 10 10 41
41 41 41 41 41 41 41 41 41 41 41 41 41 41 41 41 41 41 41 41 41 41 41 41 41 41 41 41 41 41 41 41 41 41 41 41 41 41 41 41 41 41 41 41 41 41 41 41 41 41
