41 41 41 41 41 41 41 41 41 41 41 41 41 41 41 41 41 41 41 41 41 41 41 41 41 41 41 41 41 41 41 41 41 41 41 41 41 41 41 41 41 41 41 41 41 41 41 41 41 41
41 10 10 10 10 10 10 10 10 10 10 10 10 10 10 11 10 10 10 10 10 10 10 10 10 10 10 10 10 10 10 10 11 10 10 10 10 10 10 10 10 10 10 10 10 10 10 10 10 41
41 10 10 10 10 10 10 10 10 10 10 10 10 11 10 10 10 10 10 10 10 10 10 10 10 10 10 10 10 10 11 10 10 10 10 10 10 10 10 10 10 10 10 10 10 10 10 11 10 41
41 10 10 10 10 10 10 10 10 10 10 11 10 10 10 10 10 10 10 10 10 10 10 10 10 10 10 10 11 10 10 10 10 10 10 10 10 10 10 10 10 10 10 10 10 11 10 10 10 41
41 10 10 10 10 10 10 10 10 11 10 10 10 10 10 10 10 10 10 10 10 10 10 10 10 10 11 10 10 10 10 10 10 10 10 10 10 10 10 10 10 10 10 11 10 10 10 10 10 41
41 10 10 10 10 10 10 11 10 10 10 10 10 10 10 10 10 10 10 10 10 10 10 54 55 10 10 10 10 10 10 10 10 10 10 10 10 10 10 10 10 11 10 10 10 10 10 10 10 41
41 10 10 10 10 11 10 10 10 10 10 10 10 10 10 10 10 10 10 10 10 10 11 56 54 10 10 10 10 10 10 10 10 10 10 10 10 10 10 11 10 10 10 10 10 10 10 10 10 41
41 10 10 11 10 10 10 10 10 10 10 10 10 10 10 10 10 10 10 10 11 10 10 55 56 10 10 10 10 10 10 10 10 10 10 10 10 11 10 10 10 10 10 10 10 10 10 10 10 41
41 11 10 10 10 10 10 10 10 10 10 10 10 10 10 10 10 10 11 10 10 10 10 54 55 10 10 10 10 10 10 10 10 10 10 11 10 10 10 10 10 10 10 10 10 10 10 10 10 41
41 10 10 10 10 10 10 10 10 10 10 10 54 55 56 54 11 10 54 55 56 54 10 56 54 10 56 54 55 56 10 10 10 11 10 10 10 10 10 10 10 10 10 10 10 10 10 10 10 41
41 10 10 10 10 55 56 54 55 56 54 55 56 54 55 56 54 55 56 54 55 56 54 55 56 54 55 56 54 55 56 11 10 10 10 10 10 10 10 10 10 10 10 10 10 10 10 10 11 41
41 10 10 10 10 54 55 56 54 55 56 54 55 56 54 55 56 54 55 56 54 55 56 54 55 56 54 55 56 54 55 10 10 10 10 10 10 10 10 10 10 10 10 10 10 10 11 10 10 41
41 10 10 10 10 10 10 10 10 10 11 10 10 10 10 10 10 10 10 10 10 10 10 56 54 10 10 11 10 10 10 10 10 10 10 10 10 10 10 10 10 10 10 10 11 10 10 10 10 41
41 10 10 10 10 10 10 10 11 10 10 10 10 10 10 10 10 10 10 10 10 10 10 55 56 11 10 10 10 10 10 10 10 10 10 55 56 54 55 10 10 10 11 10 10 10 10 10 10 41
41 10 10 10 10 10 11 10 10 10 10 10 10 10 10 10 10 10 10 10 10 10 10 54 55 10 10 10 10 10 10 10 10 10 10 54 55 56 54 10 11 10 10 10 10 10 10 10 10 41
41 10 10 10 11 10 10 10 10 10 10 10 10 10 10 10 10 10 10 10 10 11 10 56 54 10 10 10 10 10 10 10 10 10 10 10 10 10 11 10 10 10 10 10 10 10 10 10 10 41
41 10 11 10 10 10 10 10 10 10 10 10 10 10 10 10 10 10 10 11 10 10 10 55 56 10 10 10 10 10 10 10 10 10 10 10 11 10 10 10 10 10 10 10 10 10 10 10 10 41
41 10 10 10 10 10 10 10 10 55 56 10 10 10 10 10 10 11 10 10 10 10 10 54 55 10 10 10 10 10 10 10 10 10 11 10 10 10 10 55 56 10 10 10 10 10 10 10 10 41
41 10 10 10 10 10 10 10 10 54 55 10 10 10 10 11 10 10 10 10 10 10 10 56 54 10 10 10 10 10 10 10 11 10 10 10 10 10 10 54 55 10 10 10 10 10 10 10 10 41
41 10 10 10 10 10 10 10 10 56 54 10 10 11 10 10 10 10 10 10 10 10 10 55 56 10 10 10 10 10 11 10 10 10 10 10 10 10 10 56 54 10 10 10 10 10 10 11 10 41
41 10 10 10 10 10 10 10 10 55 56 11 10 10 10 10 10 10 10 10 10 10 10 54 55 10 10 10 11 10 10 10 10 10 10 10 10 10 10 55 56 10 10 10 10 11 10 10 10 41
41 10 10 10 10 56 54 55 56 54 55 10 10 10 10 10 10 10 10 10 10 10 10 56 54 10 11 10 10 10 10 10 10 10 10 10 10 10 10 54 55 56 54 55 56 10 10 10 10 41
41 10 10 10 10 55 56 54 55 56 54 10 10 10 10 56 54 55 10 10 10 56 54 55 56 54 55 56 54 10 10 10 55 56 54 10 10 10 10 56 54 55 56 54 55 10 10 10 10 41
41 10 10 10 10 11 10 10 10 55 56 10 10 10 10 55 56 54 10 10 10 55 56 54 55 56 54 55 56 10 10 10 54 55 56 10 10 10 10 55 56 10 10 10 10 10 10 10 10 41
41 10 10 11 10 10 54 55 56 54 55 56 54 55 56 54 55 56 54 55 56 54 55 56 54 55 56 54 55 56 54 55 56 54 55 56 54 55 56 54 55 56 54 55 56 10 10 10 10 41
41 11 10 10 10 10 56 54 55 56 54 55 56 54 55 56 54 55 56 54 55 56 54 55 56 54 55 56 54 55 56 54 55 56 54 55 56 54 55 56 54 55 56 54 55 10 10 10 10 41
41 10 10 10 10 10 10 10 10 55 56 10 10 10 10 10 11 10 10 10 10 55 56 54 55 56 54 55 56 10 10 10 10 11 10 10 10 10 10 55 56 10 10 10 10 10 10 10 10 41
41 10 10 10 10 10 10 10 10 54 55 10 10 10 11 10 10 10 10 10 10 54 55 56 54 55 56 54 55 10 10 11 10 10 10 10 10 10 10 54 55 10 10 10 10 10 10 10 11 41
41 10 10 10 10 10 10 10 10 56 54 10 11 10 10 10 10 10 10 10 10 10 10 55 56 10 10 10 10 11 10 10 10 10 10 10 10 10 10 56 54 10 10 10 10 10 11 10 10 41
41 10 10 10 10 10 10 10 10 55 56 10 10 10 10 10 10 10 10 10 10 10 10 54 55 10 10 11 10 10 10 10 10 10 10 10 10 10 10 55 56 10 10 10 11 10 10 10 10 41
41 10 10 10 10 10 10 10 11 54 55 10 10 10 10 10 10 10 10 10 10 10 10 56 54 11 10 10 10 10 10 10 10 10 10 10 10 10 10 54 55 10 11 10 10 10 10 10 10 41
41 10 10 10 10 10 11 10 10 56 54 10 10 10 10 10 10 10 10 10 10 10 10 55 56 10 10 10 10 10 10 10 10 10 10 10 10 10 10 56 54 10 10 10 10 10 10 10 10 41
41 10 10 10 11 54 55 56 54 55 56 10 10 10 10 10 10 10 10 10 10 11 10 54 55 10 10 10 10 10 10 10 10 10 10 10 10 10 11 55 56 54 55 56 54 10 10 10 10 41
41 10 11 10 10 56 54 55 56 54 55 10 10 10 10 10 10 10 10 11 10 10 10 56 54 10 10 10 10 10 10 10 10 10 10 10 11 10 10 54 55 56 54 55 56 10 10 10 10 41
41 10 10 10 10 10 10 10 10 56 54 10 10 10 10 10 10 11 10 10 10 10 10 55 56 10 10 10 10 10 10 10 10 10 11 10 10 10 10 56 54 10 10 10 10 10 10 10 10 41
41 10 10 10 10 10 10 10 10 10 10 10 10 10 10 11 10 10 10 10 10 10 10 54 55 10 10 10 10 10 10 10 11 10 10 10 10 10 10 10 10 10 10 10 10 10 10 10 10 41
41 10 10 10 10 10 12 12 12 12 10 10 10 11 10 10 10 10 10 10 10 10 10 56 54 10 10 10 10 10 11 10 10 10 10 10 10 10 10 10 10 10 10 10 10 10 10 11 10 41
41 10 10 10 10 12 12 12 12 12 12 11 10 10 10 10 10 10 10 10 10 10 10 55 56 10 10 10 11 10 10 10 10 10 10 10 10 10 10 10 10 10 10 10 10 11 10 10 10 41
41 10 10 10 10 12 12 12 12 12 12 10 10 10 10 10 10 10 10 10 54 55 56 54 55 10 11 10 10 10 10 10 10 10 56 54 55 56 10 10 10 10 10 11 10 10 10 10 10 41
41 10 10 10 10 12 12 12 12 12 12 10 10 10 10 10 10 10 10 10 56 54 55 56 54 10 10 10 10 10 10 10 10 10 55 56 54 55 10 10 10 11 10 10 10 10 10 10 10 41
41 10 10 10 10 11 12 12 12 12 54 10 10 10 10 10 10 10 10 10 55 56 54 55 56 10 10 10 10 10 10 10 10 10 54 55 56 54 10 11 10 10 10 10 10 10 10 10 10 41
41 10 10 11 10 10 10 56 54 55 56 10 10 10 10 10 10 10 10 10 54 55 56 54 55 10 10 10 10 10 10 10 10 10 56 54 55 56 10 10 10 10 10 10 10 10 10 10 10 41
41 11 10 10 10 10 10 55 56 54 55 56 54 55 56 54 55 56 54 55 56 54 55 56 54 55 56 54 55 56 54 55 56 54 55 56 54 55 56 54 55 10 10 10 10 10 10 10 10 41
41 10 10 10 10 10 10 54 55 56 54 55 56 54 55 56 54 55 56 54 55 56 54 55 56 54 55 56 54 55 56 54 55 56 54 55 56 54 55 56 54 10 10 10 10 10 10 10 10 41
41 10 10 10 10 10 10 10 10 10 10 10 10 10 11 10 10 10 10 10 10 10 10 54 55 10 10 10 10 10 10 11 10 10 10 10 10 10 10 10 10 10 10 10 10 10 10 10 11 41
41 10 10 10 10 10 10 10 10 10 10 10 11 10 10 10 10 10 10 10 10 10 10 10 10 10 10 10 10 11 10 10 10 10 10 10 10 10 10 10 10 10 10 10 10 10 11 10 10 41
41 10 10 10 10 10 10 10 10 10 11 10 10 10 10 10 10 10 10 10 10 10 10 10 10 10 10 11 10 10 10 10 10 10 10 10 10 10 10 10 10 10 10 10 11 10 10 10 10 41
41 10 10 10 10 10 10 10 11 10 10 10 10 10 10 10 10 10 10 10 10 10 10 10 10 11 10 10 10 10 10 10 10 10 10 10 10 10 10 10 10 10 11 10 10 10 10 10 10 41
41 10 10 10 10 10 11 10 10 10 10 10 10 10 10 10 10 10 10 10 10 10 10 11 10 10 10 10 10 10 10 10 10 10 10 10 10 10 10 10 11 10 10 10 10 10 10 10 10 41
41 41 41 41 41 41 41 41 41 41 41 41 41 41 41 41 41 41 41 41 41 41 41 41 41 41 41 41 41 41 41 41 41 41 41 41 41 41 41 41 41 41 41 41 41 41 41 41 41 41
